OOOOOOOOOOOOOOOOOOOOOOOXXXXXXXXXXXXXXXXX
OOOOOOOOOOOOOOOOOOOOOOOXXXXXXXXXXXXXXXXX
OOOOOOOOOOOOOOOXXXXXXOOXXXXXXXXXXXXXXXXX
OOOOOOOOOOOOOOOXXXXXXOOXXXXXXXXXXXXXXXXX
OOOOOOOXXXXXOOOXXXXXXOOXXXXXXXXXXXXXXXXX
OOOOOOOXXXXXOOOXXXXXXOOXXXXXXXXXXXXXXXXX
OOOOOOOXXXXXOOOXXXXXXOOXXXXXXXXXXXXXXXXX
OOOOOOOOOOOOOOOXXXXXXOOXXXXXXXXXXXXXXXXX
OOOOOOOOOOOOOOOXXXXXXOOXXXXXXXXXXXXXXXXX
OOOOOOOOOOOOOOOOOOOOOOOXXXXXXXXXXXXXXXXX
OOOOOOOOOOOOOOOOOOOOOOOXXXXXXXXXXXXXXXXX
OOXXXXXXXOOOOOOOOOOOOOOXXXXXXOOOOOXXXXXX
OOXXXXXXXOOOOOOOOOOOOOOXXXXXXOOOOOXXXXXX
OOXXXXXXXOOOOOOOOOOOOOOOOOOOOOOOOOOOOOOO
OOXXXXXOOOOOOOOOOOOOOOOOOOOOOOOOOOOOOOOO
OOXXXXXOOOOOOOOOOOOOOOOXXXXXXOOOOOXXXXXX
OOOOOOOOOOOOOOOOOOOOOOOXXXXXXOOOOOXXXXXX
OOOOOOOOOOOOOOOOOOOOOOOXXXXXXXXXXXXXXXXX
OOOOXXXXXXOOOOOOOOOOOOOXXXXXXXXXXXXXXXXX
OOOOXXXXXXOOOOOOOOOOOOOXXXXXXXXXXXXXXXXX
OOOOXXXXXXOOOOOOOOOOOOOXXXXXXXXXXXXXXXXX
OOOOXXXXXXOOOOOOOOOOOOOXXXXXXXXXXXXXXXXX
OOOOOOOOOOOOOOOOOOOOOOOXXXXXXXXXXXXXXXXX
OOOOOOOOOOOOOO2222OOOOOXXXXXXXXXXXXXXXXX