00000000000000000000000000000000000000000000000000000000000000000000000000000000000000000
00000000000000000000000000000000000000000000000000000000000000000000000000000000000000000
00000000000000000000000000000000000000000000000000000000000000000000000000000000000000000
00000000000000000000000000000000000000000000000000000000000002200000000000000000000000000
00000000000000000000000000000000000000000000000000000000000005500000000000000000000000000
00000000000000000000000000000000000000000000000000000000000005500000000000000000000000000
00000000000000000000000000000000000000000000000000000550000005500000000000000000000000000
00000000000000000000000000000000000000000000000000000050000005500000000000000000000000000
00000000000000000000000000000000000000000000000000000050000005500000000000000000000000000
00000000000000000000000000000000000000000000000000000050000005500000000000000000000000000
00000000000000000000000000000000000000000000000000000050000005500000000000000000000000000
00000000000000000000000000000000000000000000000000000050000005500000000000000000000000000
00000000000000000000000000000000000000000000000000000050000005500000000000000000000000000
00000000000000000000000000000000000000000000000000000050000005500000000000000000000000000
00000000000000000000000000000000000000000000555555555555555555555555555555555550000000000
00000000000000000000000000000000000000000000555555555555555555555555555555555550000000000
00000000000000000000000000000000000000000000555555555555555555555555555555555550000000000
00000000000000000000000000000000000000000000000000000005555555000000000000000000000000000
00000000000000000000000000000000000000000000000000000005555555000000000000000000000000000
00000000000000000000000000000000000000000000000000000555555555555555000000000000000000000
00000000000000000000000000000000000000000000000000000555555555555555000000000000000000000
00000000000000000000000000000000000000000000000000000055555555555555000000000000000000000
00000000000000000000000000000000000000000000000000000055555555555555000000000000000000000
00000000000000000000000000000000000000000000000000000055555555555555000000000000000000000
00000000000000000000000000000000000000000000000000000055555555555555000000000000000000000
00000000000000000000000000000000000000000000000000000055555555555555000000000000000000000
00000000000000000000000000000000000000000000000000000055555555555555000000000000000000000
00000000000000000000000000000000000000000000000000000055555555555555000000000550000000000
00000000000000000000000000000000000000000000555555555555555555555555000000000550000000000
00000000000000000000000000000000000000000000555555555555555555555555555555000555550000000
00000000000000000000000000000000000000000000555555555555555555555555555555000555550000000
00000000000000000000000000000000000000000000555555555555555555555555555555555555550000000
00000000000000000000000000000000000000000000555555555555555555555555555555555555550000000
00000000000000000000000000000000000000000000555555555555555555555555555555555555550000000
00000000000000000000000000000000000000000000000000000005555555000000000000000000000000000
00000000000000000000000000000000000000000000000000000005555555000000000000000000000000000
00000000000000000000000000000000000000000000555555555555555555555555555555555555550000000
00000000000000000000000000000000000000000000000000000555555555555555000000000000000000000
00000000000000000000000000000000000000000000000000000555555555555555000000000000000000000
00000000000000000000000000000000000000000000000000000055555555555555000000000000000000000
00000000000000000000000000000000000000000000000000000055555555555555000000000000000000000
00000000000000000000000000000000000000000000000000000055555555555555000000000000000000000
00000000000000000000000000000000000000000000000000000055555555555555000000000000000000000
00000000000000000000000000000000000000000000000000000055555555555555000000000000000000000
00000000000000000000000000000000000000000000000000000055555555555555000000000000000000000
00000000000000000000000000000000000000000000000000000055555555555555000000000550000000000
00000000000000000000000000000000000000000000555555555555555555555555000000000550000000000
00000000000000000000000000000000000000000000555555555555555555555555555555000555550000000
00000000000000000000000000000000000000000000555555555555555555555555555555000555550000000
00000000000000000000000000000000000000000000555555555555555555555555555555555555550000000
00000000000000000000000000000000000000000000555555555555555555555555555555555555550000000
00000000000000000000000000000000000000000000000000000000000000000000000000000000000000000